111111111111111111111111111111
1E0000000000000C000T0C00000001
1P1001010010000010100100000001
101001001010101000100100000001
101001001010101000100100000001
101001001010101000100100000001
101001001010101000100100000001
100000000C00C00000000000000001
111111111111111111111111111111