111111111111111111111111111111111111111111111111111111111111
1E0000000000000C00000C00000000000100000000000000000000000001
1P1001010010000010100100000001010100000000000000000000000001
101001001010101000100100000001010100000000000000000000000001
101001001010101000100100000001010100000000000000000000000001
101001001010101000100100000001010100000000000000000000000001
101001001010101000100100000001010100000000000000000000000001
100000000C00C0000000000000000000C100000000000000000000000001
111111111111111111111111111111111111111111111111111111111111