11111111
1PCE0001
11100001
11111111